1111111111111111
10C0000000000001
1CPC010000000001
10C01C00000C0111
10011000000101C1
101C000000010101
1000011110010001
1000010C10010001
1100010110010001
1100000000000001
1100000000000001
1000000000111001
10011110001E0001
100CCCC000100001
1000000000000001
1111111111111111
