1111111111111111111
100000C00000C000001
1010011100011100101
1011000000000001101
100110011C110011001
1000110011100110001
1010011001001100101
10C000110P011000C01
101010C11111C010101
100000110E011000001
1C100110010011001C1
1100110011100110011
100110000C000011001
1011001000001001101
1010011011101100101
10000C10CCC01C00001
1111111111111111111
