111111111111
100000000001
101110000001
101C1000E001
101110000001
100000000001
100000000001
100000000001
100000000001
100000000P01
100000000001
111111111111